3
4 0
2 1 1 1 1 1 0
1 1 1 1 1 0 1
1 1 1 0 1 1 1
1 0 1 1 1 1 2
5 0
2 1 1 1 1 1 1
1 1 1 1 0 1 0
1 1 1 1 1 1 1
1 0 1 1 0 1 1
1 0 1 1 1 0 2
5 0
2 1 0 1 1 1 1
1 0 1 1 1 1 1
0 1 1 1 1 1 1
1 1 0 1 1 1 1
1 1 1 0 1 1 2